手紙のGreeting（1・2の相手の名前はMike Wattie）<br><div>1: 友人や家族に対して</div><div>2: 上司に対して</div><div>3: 知らない相手に対して</div>	1: Dear Mike,<div>2: Dear Mike Wattie,</div><div>3: Dear Sir or Madam,</div>	
手紙のForewellと名前<div>1: formal（会ったことない人）</div><div>2: formal（会ったことある人）</div><div>3: semi-formal（よく知っている人）</div>	1:<div>Yours faithfully,</div><div>Yohei Meguro</div><div><br></div><div>2:</div><div><div>Yours sincerely,</div><div>Yohei Meguro</div></div><div><br></div><div>3:</div><div>Best regards,</div><div>Yohei</div>	
<div>ホテルの宿泊先の詳細をお聞きしたくて書いています。<br></div><div><br></div><div>※ ask if を使う</div><div>（Task1 の requesting information の場合の書き出し）<br></div>	I am writing to ask if you would be so kind as to give me some details about your hotel's accomodation.	
<div>親切なご協力ありがとうございます。<br></div><div><br></div>Task1 の requesting information の場合の書き終わりの挨拶<div>※ Thank you を使う</div>	<div><div>Thank you in advance for your kind cooperation.</div></div><div><br></div><div>in advance は「前もって」</div><div>ただ相手の承諾を前提としているので、少し押し付けがましい響きを伴うこともある。ビジネスで使う場合は注意。</div>	
<div>私のお願いが、あまりご迷惑をおかけしないことを願っています。<br></div><div><br></div>Task1 の requesting information の場合の書き終わりの挨拶<div>※ I hope を使う</div>	<div><div>I hope that my request will not inconvenience you too much.</div></div>	
<div>この件に関しては、お時間とご配慮に感謝しております。<br></div><div><br></div>Task1 の requesting information の場合の書き終わりの挨拶<br>※ I appreciate を使う	<div><div>I appreciate your time and attention to this matter.</div></div>	
<div>この情報が少しでも参考になれば幸いです。<br></div><div><br></div>Task1 の giving information の場合の書き終わりの挨拶<br>※ I hope を使う	<div><div>I hope that this information will be of some assistance.</div></div>	
<div>何かご不明な点がありましたら、お気軽にご連絡ください。<br></div><div><br></div>Task1 の giving information の場合の書き終わりの挨拶<br>※ Please と if を使う	<div><div>Please do not hesitate to contact me if you have any further questions.</div></div>	
<div>ご不明な点がございましたら、お気軽にお問い合わせください。<br></div><div><br></div>Task1 の giving information の場合の書き終わりの挨拶<br>※ Do not と should を使う	<div><div>Do not hesitate to contact me should you require further assistance.</div></div>	
この手紙の目的は、あなたの雑誌に対する私の意見を述べることです。<div><br></div><div>Task1 の giving information<br></div>	<div><div>The purpose of this letter is to express my opinion about your magazine.</div></div>	
先日、お店で購入した商品にある不満があるため、手紙を書かせていただきました。<div><br></div><div>Task1 の making an complaint<br></div>	<div><div>I am writing to express my dissatisfaction with a product I purchased recently from one of your stores.</div></div>	
一日も早くこの件が解決することを願っています。<div><br></div><div>Task1 の making a complaint の場合の書き終わりの挨拶<br></div>	I hope this matter will be resolved as soon as possible.	
<div>この件については、早急にご連絡をいただければと思います。<br></div><div><br></div><div>Task1 の making a complaint の場合の書き終わりの挨拶<br></div>	I hope this matter will receive your immediate attention.	
<div>改めて、ご迷惑をおかけして申し訳ありませんでした。<br></div><div><br></div><div>Task1 の making an apology の場合の書き終わりの挨拶<br></div>	<div><div>Once again, my apologies for the inconvenience caused.</div></div>	
私の謝罪を受け入れてくれることを願っています。<br><div><br></div><div>Task1 の making an apology の場合の書き終わりの挨拶<br></div>	I hope that you will accept my apologies.	
<div>この残念なミスを見過ごしていただきたいと思います。<br></div><br><div>Task1 の making an apology の場合の書き終わりの挨拶<br></div>	I hope that you can overlook this regrettable error.	
先週の土曜日の夜の誕生日会でお騒がせしたことを心よりお詫び申し上げます。<div><br></div><div>Task1 の making an apology<br></div>	<div><div>I am writing to sincerely apologise for the disturbance caused during my birthday party last Saturday night.</div></div>	
心よりお詫び申し上げます。<div><br></div><div>Task1 の making an apology<br></div><div>my most を使う</div>	Please accept my most sincere apologies.	
誕生日を覚えていてくれたことに感謝の気持ちを込めて書いています。<br><div><br></div><div>Task1 の thanking someone の書き出し<br></div>	<div><div>I am writing to express my gratitude for remembering my birthday.</div></div>	
<div>改めて、私の誕生日を覚えていてくれて本当に感謝しています。<br></div><div><br></div>Task1 の thanking someone の締め	<div><div>Once again I really appreciated you remembering my birthday.</div></div>	
現在、XYZかどうかが議論されています。<div><br></div><div>opinion essayのIntroductionの表現</div><div>whether XYZ を使って</div>	There is currently a contentious argument over whether XYZ	
私はxxxという理由でこの意見に完全に同意しません。<div><br></div><div><div>opinion essayのIntroductionの表現</div><div>because xxx を使って</div></div>	I totally disagree with this opinion because xxx	
<div>私がXYZを信じる主な理由はxxxです。</div><div><br></div><div>opinion essayのparagraph2の表現</div><div>believe XYZ と because xxx を使って</div>	The main reason why I believe XYZ is because xxx	
<div>私がXYZという概念を支持するもう一つの理由は、その事実に起因するxxxという事実のためです。<br></div><div><br></div>opinion essayのparagraph3の表現<br>XYZ と xxx を使って	Another reason why I support the notion that XYZ is due to the fact that xxx	
<div>結論としては、私はXYZに対してreasonAとreasonBの理由から完全に同意できません。</div><div><br></div>opinion essayのconclusionの表現<br>XYZ と reasonA、reasonB&nbsp;を使って	<div>In conclusion, I completely disagree that XYZ because reasonA and reasonB</div>	
<div>このような状況を考えるとxxxと思えます。</div><div><br></div>opinion essayのconclusionの表現<br>xxx を使って	<div><div>Given this situation, it seems that xxx.</div></div>	
このエッセイでは、この議論の賛否両論を論じた上で、私なりの見解を述べます。<div><br><div>Task2 の both sides and opinion essay の場合の Introduction</div></div>	<div><div>This essay discusses both sides of this argument, and then I will give my own perspective.</div></div>	
このエッセイの目的は、この議論の双方を分析した上で、私が学校には他の機能があるべきだと考える理由を説明することである。<br><div><br></div><div>Task2 の both sides and opinion essay の場合の Introduction<br></div>	<div><div>The purpose of this essay is to analyse both sides of this argument and then I will explain why I believe the view that schools should have other functions is stronger.</div></div>	
結論から言うと、賛否両論あると思います。	In conclusion, I believe both sides of the argument have their merits.<div><br></div><div>Task2 の both sides and opinion essay の場合の Conclusion で使う<br></div>	
<div>今日、非常に論議を呼んでいるのは、xxxを持つべきかどうかということである。このエッセイでは、この問題を両方の視点から検証した上で、この問題についての私の意見を述べたいと思います。<br></div><div><br></div>Task2 の both sides and opinion essay の場合のテンプレート。 Introduction 部分	<div><div>A highly controversial issue today relates to whether to have ...[xxx]... or not. In this essay, I am going to examine this question from both points of view and then give my own opinion on the matter.</div></div>	
<div>aaaのメリットは、そのデメリットをかなり上回ると主張する人がいます。これを信じる主な理由はbbbです。cccと言うことも可能です。その良い例として、dddがあります。<br></div><div><br></div>Task2 の both sides and opinion essay の場合のテンプレート。 Body1 部分<div>main reason と illustration を使う<br></div>	<div><div>There are people who argue that the benifits of [aaa] considerably outweigh its disadvantages. The main reason for believing this is that [bbb]. It is also possible to say that [ccc]. One good illustration of this is [ddd].</div></div>	
<div>一方で、反論することも可能です。それはしばしば、[aaa]と主張されています。人々がよくこのような意見を持つのは、[bbb]だからです。 2つ目のポイントは、[ccc]です。ここで特に良い例が[ddd]です。</div><div><br></div>Task2 の both sides and opinion essay の場合のテンプレート。 Body2 部分	On the other hand, it is also possible to make the opposing case. It is often argued that [aaa]. People often have this opinion because [bbb]. A second point is that [ccc]. A particularly good example here is [ddd].	
<div>結論から言うと、私はどちらの議論にもメリットがあると考えています。しかしバランス的には、私は[aaa]を感じる。というのも[bbb]のためである。<br></div><div><br></div>Task2 の both sides and opinion essay の場合のテンプレート。 Conclusion 部分	<div><div>In conclusion, I believe both arguments have their merits. On balance, however, I feel that [aaa]. This is because [bbb].</div></div>	
aaaは多くの国で深刻化しています。bbbは多くの社会を脅かしていますが、その影響をうまく食い止めることもできます。このエッセイでは、社会上のcccによって引き起こされる問題のいくつかを見て、問題のいくつかの解決策を提案しています。<div><br></div><div>Task2 の two question essay の場合のテンプレート。 Introduction 部分<br></div>	[aaa] is becoming increasingly serious in many nations. Although [bbb] threaten many societies, its/their effects can also be combated successfully. This essay looks at some of the problems caused by [ccc] on society, and suggests some solutions to the problems.	
aaaは複数の問題を引き起こす。bbbの影響は非常に明白です 例えばcccです。dddのようないくつかのケースでは、死にさえつながります。第2の効果はeeeです。fffの人はgggになります。<br><div><br></div><div>Task2 の two question essay の場合のテンプレート。 Body1 部分<br></div>	[aaa] causes multiple problems. The [bbb] effects are very obvious. For example, [ccc] . In some cases, such as [ddd] even leads to death. The second effect is [eee] . People who [fff] become [ggg] .	
<div>しかし、[aaa]の脅威は戦うことができます。教育は、この問題に取り組むための主な方法です。彼らはこの問題を避けることができるように、人々は効果を認識する必要があります。さらに、政府は[bbb]もできます。これは、[ccc]のための良いアプローチです。<br></div><div><br></div>Task2 の two question essay の場合のテンプレート。 Body2 部分	However, the menace of [aaa] can be fought. Education is the main way to tackle this issue. People need to be aware of the effects so that they can avoid this problem. In addition, the government could also [bbb]. This is a good approach because [ccc].	
<div>結論から言うと、[aaa]は人々の健康や[bbb]の人々に有害な影響を与えるので、深刻な問題である。この問題に対処するための最善の方法は、人々にその有害な影響について教育することであり、また、政府が[ccc]することです。問題は、短期的に完全に排除される可能性は低いですが、それが現在の社会に与えている影響を軽減するための具体的な手順があります。<br></div><div><br></div>Task2 の two question essay の場合のテンプレート。 Conclusion 部分	In conclusion, [aaa] is a serious issue because it causes harmful effects on people's health and people who are [bbb]. The best approaches to deal with it are to educate people about its damaging effects, and also for the government to [ccc]. Although the problem is unlikely to be entirely eliminated in the short term there are concrete steps to reduce the effects it is having on the current society.	
childrenのrephrase2つ	<div>ˈdʒuvʌnʌlz<br></div>juveniles<div><br></div><div>ˈjʌŋstɝz<br><div>youngsters</div></div>	
educationのrephrase3つ	learning / instruction / acquiring knowledge	
studentsのrephrase1つ	pupils	
parentsのrephrase3つ	<div>ˈkɛˌrgɪvɝz<br></div>caregivers<div><br></div><div>ˈgɑrdiʌnz<br></div><div>guardians</div><div><br></div><div>mothers and fathers</div>	
schoolsのrephrase1つ	educational institutions	
societyのrephrase2つ	community / citizens	
teachersのrephrase1つ	educators	
healthのrephrase3つ（健康）	well-being / physical condition / fitness	
healthyのrephrase2つ（健康な）	fit / in good condition<div><br></div><div>Is&nbsp;she&nbsp;fit&nbsp;to&nbsp;travel?</div><div>彼女はもう元気で旅行ができますか？<br></div>	
unhealthyのrephrase2つ	unwell / poor medical condition	
sick peopleのrephrase2つ	patients / people who are unwell	
treatmentのrephrase2つ（治療）	cure / healing	
sicknessのrephrase1つ（病気）	medical condition	
influenceのrephrase1つ（影響）	effect on<div><br></div><div>It&nbsp;had&nbsp;no&nbsp;effect&nbsp;on&nbsp;me.<br></div><div>利き目が無かった<br></div>	
negative developmentのrephrase1つ	harmful trend	
internetのrephrase1つ	cyberspace	
mediaのrephrase1つ	paparazzi（ネガティブな意味）ˌpɑpɑˈrɔˌzi	
popularityのrephrase2つ（人気）	fame / attractiveness	
recentのrephrase1つ	contemporary	
advancesのrephrase1つ	developments	
improveのrephrase2つ	enhance / progress<div><br></div><div><div><div>Have you&nbsp;progressed&nbsp;in&nbsp;your&nbsp;studies?</div><div>研究は進みましたか。</div></div></div>	
technologyのrephrase1つ	<div>ʌˈdvænsmʌnts<br></div>scientific advancements	
punishmentのrephrase1つ	penalty&nbsp;pénlti	
crimeのrephrase3つ	law-breaking / transgression / offense	
lawsのrephrase2つ	regulations / rules	
environmentのrephrase2つ	biosphere / ecosystem	
damageのrephrase1つ	devastation&nbsp;dèvəstéɪʃən<div>荒廃、惨害</div>	
pollutionのrephrase1つ	contamination	
problemsのrephrase1つ	issues	
solutionsのrephrase2つ	solving / ways to tackle	